СПИСОК СОКРАЩЕНИЙ:
Anti-HCV – антитела к вирусу гепатита С
Anti-HBc – антитела к ядерному антигену вируса гепатита В
HBcAg – hepatitis B core antigen, ядерный антиген вируса гепатита В
HBsAg – hepatitis B surface antigen, поверхностный антиген вируса гепатита В
HBV – hepatitis B virus, вирус гепатита В
HCVcAg – hepatitis C virus core antigen, ядерный антиген вируса гепатита С
HIV – human immunogenicity virus, вирус иммунодефицита человека
MELD – model of end liver disease, расчетный индекс, характеристика тяжести
NS3/4A ингибиторы – противовирусные средства для лечения гепатита C, блокируют
NS5A ингибиторы – противовирусные средства для лечения гепатита C, блокируют
АЛТ – аланиновая аминотрансфераза
АСТ – аспарагиновая аминотрансфераза
АФП – альфа-фетопротеин
ВГВ – вирус гепатита В
ВГС – вирус гепатита С
ВЕЛ+СОФ – велпатасвир + софосбувир**
ВН – вирусная нагрузка
ВИЧ – вирус иммунодефицита человека
ВРВ – варикозно расширенные вены
ГГТ – гамма-глутамилтрансфераза
ГЛЕ+ПИБ – глекапревир + пибрентасвир**
ГРА+ЭЛБ – гразопревир + элбасвир**
ГТ – генотип
ГЦК – гепатоцеллюлярная карцинома
ДАК – даклатасвир**
ДСВ; ОБВ+ПТВ/р – дасабувир; омбитасвир + паритапревир + ритонавир**
ДНК – дезоксирибонуклеиновая кислота
ЖНЛВП – жизненно необходимые и важнейшие лекарственные препараты
ЛЕД+СОФ – ледипасвир + софосбувир
МЕ – международная единица
МКБ 10 – Международная классификация болезней 10-го пересмотра
НРВ – нарлапревир**
ОТП – ортотопическая трансплантация печени
ПегИФН – Пэгинтерферон альфа-2a (40 кДа)** или Пэгинтерферон альфа 2b **
ПППД – противовирусные препараты прямого действия
ПТИ – протромбиновый индекс
РБВ – рибавирин**
РНК – рибонуклеиновая кислота
р/д – раз в день
СКФ – скорость клубочковой фильтрации
СОФ – софосбувир**
таб. – таблетка
УЗИ – ультразвуковое исследование
УВО – устойчивый вирусологический ответ через 12 недель после окончания терапии
ХБП – хроническая болезнь почек
ХВГС – хронический вирусный гепатит С
ЦП – цирроз печени

3. Лечение, включая медикаментозную и немедикаментозную терапии, диетотерапию, обезболивание, медицинские показания и противопоказания к применению методов лечения Цель лечения ХВГС – элиминация ВГС для профилактики осложнений ХВГС (включая ЦП, ГЦК, смерть), улучшение качества жизни и предотвращение дальнейшей передачи ВГС в популяции. Вирус гепатита С не образует высокостабильных внутриклеточных форм генетического материала, поэтому может быть элиминирован из организма полностью. Показателем элиминации вируса из организма является стойкое достижение неопределяемого уровня РНК вируса в крови, которое оценивают через 12 недель после окончания терапии (УВО ). 12 На выбор тактики лечения оказывают влияние следующие факторы: o стадия фиброза печени, наличие ЦП и его класс; o ГТ ВГС; o наличие некоторых сопутствующих заболеваний; o опыт предыдущей ПВТ (если есть); o прием лекарственных средств по поводу сопутствующей патологии.
3.1 Показания к началу противовирусной терапии  Противовирусное лечение рекомендуется проводить всем пациентам с ХВГС, независимо от наличия ЦП, с целью излечения от инфекции (эрадикации ВГС) (см. также Приложение А3). Уровень убедительности рекомендаций А (уровень достоверности доказательств – 1) Комментарии: лечение ХВГС показано всем больным, так как в настоящее время применяются высокоэффективные и безопасные препараты, которые позволяют добиться УВО в подавляющем большинстве случаев. Для лечения ХВГС применяются противовирусные препараты прямого действия (ПППД). Те из них, которые входят в список ЖНЛВП, отмечаются знаком **. ПППД представляют собой ингибиторы различных неструктурных белков вируса. Второй корень названия ПППД указывает на то, какой конкретно белок он ингибирует: «-превир» – NS3/NS4A, «-асвир» – NS5А, «-бувир» – NS5B. Выбор препаратов для лечения и длительность лечения зависят от стадии фиброза, наличия и класса ЦП, ГТ вируса, опыта предшествующей терапии ХВГС, наличия сопутствующих заболеваний (в частности, хронической болезни почек (ХБП)), некоторых препаратов сопутствующей терапии. В зависимости от эффективности при различных ГТ выделяют пангенотипные схемы (эффективны при всех ГТ вируса) и генотип-специфические (эффективны только при определенных ГТ ВГС). В табл. 1 представлены лекарственные средства и их компоненты, применяющиеся в РФ. Табл. 1.Фиксированные комбинированные ПППД:  Велпатасвир + софосбувир** (ВЕЛ+СОФ**)  Глекапревир + пибрентасвир** (ГЛЕ+ПИБ**)  Гразопревир + элбасвир** (ГРА+ЭЛБ**)  Дасабувир; омбитасвир + паритапревир + ритонавирб** (ДСВ; ОБВ+ПТВ/р**)  Ледипасвир + софосбувир (ЛЕД+СОФ) Примечания: а - входят в состав комбинированных препаратов; б - ритонавир** (РТВ**) – фармакокинетический бустер, не обладает противовирусной активностью, используется с НРВ** и ПТВ для увеличения их концентрации в крови.  Безотлагательно терапию рекомендуется рассмотреть в первую очередь у пациентов: o с ХВГС с исходом в ЦП (включая декомпенсированный ЦП); o с выраженным фиброзом (F3 по METAVIR); o с клинически значимыми внепеченочными проявлениями; o с рецидивом ХВГС после трансплантации печени; o с риском быстрого развития заболевания печени по причине сопутствующих заболеваний (хронический вирусный гепатит В, ВИЧ-инфекция, сахарный диабет и др., после трансплантации других органов кроме печени); o с высоким риском передачи инфекции. Уровень убедительности рекомендаций А (уровень достоверности доказательств – 1)  Перед применением ПППД рекомендуется проверить сочетаемость назначенной схемы с уже принимаемыми пациентом препаратами, используя любой специальный ресурс (например, https://www.hep-druginteractions.org). При выявлении значимого взаимодействия рекомендуется заменить схему или препарат, который пациент принимает при лечении сопутствующего заболевания. Если это невозможно, решение следует принимать в индивидуальном порядке, оценивая соотношение пользы и риска от данной комбинации и возможных последствий от ее применения. Уровень убедительности рекомендаций С (уровень достоверности доказательств – 4) Комментарии: Большинство ПППД безопасно, но особенности их фармакокинетики могут приводить к значимому взаимодействию с другими препаратами, принимаемыми пациентом.
3.2 Лечение пациентов без цирроза печени и с компенсированным циррозом печени Поскольку наличие опыта предшествующей терапии и ЦП существенно влияет на эффективность ПВТ, ее состав и длительность различается в зависимости от наличия этих факторов. В связи с этим пациентов с ХВГС принято разделять на несколько групп: o Пациенты без опыта ПВТ и без ЦП; o Пациенты без опыта ПВТ с компенсированным ЦП; o Пациенты, не ответившие на предшествующую ПВТ (ПегИФН** + РБВ** ± СОФ** или СОФ** + РБВ**) без ЦП; o Пациенты, не ответившие на предшествующую ПВТ (ПегИФН** + РБВ** ± СОФ** или СОФ** + РБВ**) с компенсированным ЦП. Лечение пациентов с декомпенсированным ЦП рассматриваются отдельно в разделе 3.9 «Трансплантация печени» и в Приложении А3. Принципы перелечивания после неуспешного курса ПППД (ингибиторующими NS3/4А и/или ингибиторующими NS5A) рассматриваются в разделе 3.4.  Лечение пациентов с ХВГС без ЦП, без опыта ПВТ и без трансплантации печени в анамнезе рекомендуется проводить по одной из альтернативных схем согласно табл. 2: -Велпатасвир+Софосбувир** Уровень убедительности рекомендаций A (уровень достоверности доказательств – 2) -Глекапревир + Пибрентасвир** Уровень убедительности рекомендаций A (уровень достоверности доказательств – 2) -Даклатасвир** + Софосбувир** Уровень убедительности рекомендаций А (уровень достоверности доказательств – 3) -Гразопревир + Элбасвир** Уровень убедительности рекомендаций A (уровень достоверности доказательств – 2) -Даклатасвир** + Нарлапревир** + Ритонавир** Уровень убедительности рекомендаций С (уровень достоверности доказательств – 4) -Дасабувир; Омбитасвир + Паритапревир + Ритонавир** при генотипе 1b, -Дасабувир; Омбитасвир + Паритапревир + Ритонавир** + Рибавирин** при генотипе 1а Уровень убедительности рекомендаций A (уровень достоверности доказательств – 2) -Ледипасвир + Софосбувир Уровень убедительности рекомендаций A (уровень достоверности доказательств – 3) -Нарлапревир** + Софосбувир** + Ритонавир** Уровень убедительности рекомендаций В (уровень достоверности доказательств – 3) Табл. 2. Схемы ПВТ ХВГС для пациентов без предшествующего опыта ПВТ и без цирроза печени в зависимости от генотипа (лекарственные средства представлены в алфавитном порядке). Пангенотипные схемы лечения Генотип-специфичные схемы лечения ГЛЕ + ДАК**+ ДСВ; ВЕЛ + ДАК** + ГРА + ЛЕД + НРВ**/р** ГТ ПИБ* НРВ**/р* ОБВ+П СОФ** СОФ** ЭЛБ** СОФ + СОФ** * * ТВ/р** 12/16 12 нед. + 1а - нед.а РБВ** 12 нед. 8 нед. 8/12 #8 нед. в 1b 8/12 нед.б 12 нед. нед.б 2 12 нед. 8 нед. 12 нед. - - - - - 12 нед + 3 - - - - СОФ** 12/16 4 - - 12 нед. - нед.а Примечания: ВЕЛ+СОФ** – велпатасвир + софосбувир** (100/400 мг) 1 таб. 1р/д; ГЛЕ+ПИБ** – глекапревир + пибрентасвир** (3 таб. одновременно, по 100/40 мг каждая) 1р/д; ДАК** + СОФ** – даклатасвир** 60 мг 1 таб. 1р/д + софосбувир** 400 мг 1 таб. 1р/д; ГРА+ЭЛБ** – гразопревир + элбасвир** 100/50 мг 1 таб. 1р/д; ДАК** + НРВ**/р** – даклатасвир** 60 мг 1р/д + нарлапревир** 200 мг 1 р/д (2 таб. одновременно, по 100 мг каждая) + ритонавир** 100 мг 1р/д; ДСВ; ОБВ+ПТВ/р** – дасабувир (1 таб. по 250 мг 2 р/д); омбитасвир + паритапревир + ритонавир** (2 таб. одновременно 1р/д, по 12,5/75/50 мг каждая); ЛЕД+СОФ – ледипасвир + софосбувир 90/400 мг 1 таб. 1р/д; НРВ**/р** + СОФ** – нарлапревир** 200 мг 1 р/д (2 таб. одновременно, по 100 мг каждая) + ритонавир** 100 мг 1р/д + софосбувир** 400 мг 1 таб. 1р/д; а - при ВН не более 800 000 МЕ/мл срок лечения 12 недель; 16-недельный курс совместно с РБВ** следует рассмотреть при ВН ВГС >800 000 ME/мл и/или при наличии полиморфизмов NS5A; б - у пациентов со слабовыраженным фиброзом (F0-2) 8 недель, с фиброзом F3-F4 по METAVIR – 12 недель. в - у пациентов со слабовыраженным фиброзом (F0-2) и ВН менее 1 000 000 МЕ/мл можно рассмотреть длительность 8 недель по решению врачебной комиссии.  Лечение пациентов с ХВГС с компенсированным ЦП без опыта ПВТ рекомендуется проводить по одной из альтернативных схем согласно табл. 3: -Велпатасвир + Софосбувир** Уровень убедительности рекомендаций A (уровень достоверности доказательств – 3) -Глекапревир + Пибрентасвир** Уровень убедительности рекомендаций A (уровень достоверности доказательств – 4) -Даклатасвир** + Софосбувир** при генотипе 1, 2 и 4 Уровень убедительности рекомендаций A (уровень достоверности доказательств – 3) -Даклатасвир** + Софосбувир** + Рибавирин** при генотипе 3 Уровень убедительности рекомендаций A (уровень достоверности доказательств – 3) -Гразопревир + Элбасвир** Уровень убедительности рекомендаций A (уровень достоверности доказательств – 2) -Дасабувир; Омбитасвир + Паритапревир + Ритонавир** при генотипе 1b, -Дасабувир; Омбитасвир + Паритапревир + Ритонавир** + Рибавирин** при генотипе 1а Уровень убедительности рекомендаций A (уровень достоверности доказательств – 2) -Ледипасвир + Софосбувир или Ледипасвир + Софосбувир + Рибавирин** Уровень убедительности рекомендаций A (уровень достоверности доказательств – 3) Табл. 3.Примечания: ВЕЛ+СОФ** – велпатасвир + софосбувир** (100/400 мг) 1 таб. 1р/д; ГЛЕ+ПИБ** – глекапревир + пибрентасвир** (3 таб. одновременно, по 100/40 мг каждая) 1р/д; ДАК**+СОФ** – даклатасвир** 60 мг 1 таб. 1р/д + софосбувир** 400 мг 1 таб. 1р/д; ГРА+ЭЛБ** – гразопревир + элбасвир** 100/50 мг 1 таб. 1р/д; ДСВ; ОБВ+ПТВ/р** – дасабувир (1 таб. по 250 мг 2 р/д); омбитасвир + паритапревир + ритонавир** (2 таб. одновременно 1р/д, по 12,5/75/50 мг каждая); ЛЕД+СОФ – ледипасвир + софосбувир 90/400 мг 1 таб. 1р/д; а - при ВН не более 800 000 МЕ/мл срок лечения 12 недель; 16-недельный курс совместно с РБВ** следует рассмотреть при ВН ВГС >800 000 ME/мл и/или при наличии полиморфизмов NS5A; б - для ГТ 3 можно рассмотреть добавление РБВ**; в - в случае недоступности иных схем лечения.  Лечение пациентов с ХВГС, не ответивших на предшествующую терапию ПегИФН** + РБВ** ± СОФ** или СОФ** + РБВ**, без ЦП рекомендуется проводить по одной из альтернативных схем согласно табл. 4: -Велпатасвир + Софосбувир** Уровень убедительности рекомендаций A (уровень достоверности доказательств – 3) -Глекапревир + Пибрентасвир** Уровень убедительности рекомендаций A (уровень достоверности доказательств – 3) - Даклатасвир** + Софосбувир** Уровень убедительности рекомендаций A (уровень достоверности доказательств – 3) -Гразопревир + Элбасвир** Уровень убедительности рекомендаций A (уровень достоверности доказательств – 2) -Дасабувир; Омбитасвир + Паритапревир + Ритонавир** при генотипе 1b, -Дасабувир; Омбитасвир + Паритапревир + Ритонавир** + Рибавирин** при генотипе 1а Уровень убедительности рекомендаций A (уровень достоверности доказательств – 2) -Ледипасвир + Софосбувир или Ледипасвир+Софосбувир + Рибавирин** Уровень убедительности рекомендаций A (уровень достоверности доказательств – 3) Табл. 4. Схемы ПВТ ХВГС для пациентов, не ответивших на предшествующую терапию ПегИФН** + РБВ** ± СОФ** или СОФ** + РБВ**, без цирроза печени в зависимости от генотипа (лекарственные средства представлены в алфавитном порядке). Пангенотипные схемы лечения Генотип-специфичные схемы лечения ВЕЛ + ГЛЕ + ГРА + ДСВ; ГТ ДАК** + СОФ** ЛЕД + СОФ СОФ** ПИБ** ЭЛБ** ОБВ+ПТВ/р** 12/16 1а 12 нед.+ РБВ** 12 нед. 8 нед. 12 нед. нед.а 12 недель 1b 12 нед. 12 нед. 2 - - - 3 16 нед. - - 24 нед + РБВ** 12/16 4 8 нед. - 12 недель нед.а Примечания: ВЕЛ+СОФ** – велпатасвир + софосбувир** (100/400 мг) 1 таб. 1р/д; ГЛЕ+ПИБ** – глекапревир + пибрентасвир** (3 таб. одновременно, по 100/40 мг каждая) 1р/д; ДАК** + СОФ** – даклатасвир** 60 мг 1 таб. 1р/д + софосбувир** 400 мг 1 таб. 1р/д; ГРА+ЭЛБ** – гразопревир + элбасвир** 100/50 мг 1 таб. 1р/д; ДСВ; ОБВ+ПТВ/р** – дасабувир (1 таб. по 250 мг 2 р/д); омбитасвир + паритапревир + ритонавир** (2 таб. одновременно 1р/д, по 12,5/75/50 мг каждая); ЛЕД+СОФ – ледипасвир + софосбувир 90/400 мг 1 таб. 1р/д; а – при ВН не более 800 000 МЕ/мл срок лечения 12 недель; 16-недельный курс совместно с РБВ** следует рассмотреть при ВН ВГС >800 000 ME/мл и/или при наличии полиморфизмов NS5A.  Лечение пациентов с ХВГС, не ответивших на предшествующую терапию ПегИФН** + РБВ** ± СОФ** или СОФ** + РБВ**, с компенсированным ЦП рекомендуется проводить по одной из альтернативных схем согласно табл. 5: -Велпатасвир + Софосбувир** Уровень убедительности рекомендаций A (уровень достоверности доказательств – 2) -Глекапревир + Пибрентасвир** Уровень убедительности рекомендаций A (уровень достоверности доказательств – 3) -Даклатасвир** + Софосбувир** Уровень убедительности рекомендаций A (уровень достоверности доказательств – 3) -Даклатасвир** + Софосбувир** + Рибавирин** Уровень убедительности рекомендаций A (уровень достоверности доказательств – 2) -Гразопревир + Элбасвир** Уровень убедительности рекомендаций A (уровень достоверности доказательств – 2) -Дасабувир; Омбитасвир + Паритапревир + Ритонавир** при генотипе 1b, -Дасабувир; Омбитасвир + Паритапревир + Ритонавир** + Рибавирин** при генотипе 1а Уровень убедительности рекомендаций A (уровень достоверности доказательств – 2) -Ледипасвир + Софосбувир или Ледипасвир+Софосбувир + Рибавирин** Уровень убедительности рекомендаций A (уровень достоверности доказательств – 3) Табл. 5.Примечания: ВЕЛ+СОФ** – велпатасвир + софосбувир** (100/400 мг) 1 таб. 1р/д; ГЛЕ+ПИБ** – глекапревир + пибрентасвир** (3 таб. одновременно, по 100/40 мг каждая) 1р/д; ДАК** + СОФ** – даклатасвир** 60 мг 1 таб. 1р/д + софосбувир** 400 мг 1 таб. 1р/д; ГРА+ЭЛБ** – гразопревир + элбасвир** 100/50 мг 1 таб. 1р/д; ДСВ; ОБВ+ПТВ/р** – дасабувир (1 таб. по 250 мг 2 р/д); омбитасвир + паритапревир + ритонавир** (2 таб. одновременно 1р/д, по 12,5/75/50 мг каждая); ЛЕД+СОФ – ледипасвир + софосбувир 90/400 мг 1 таб. 1р/д; а - при ВН не более 800 000 МЕ/мл срок лечения 12 недель; 16-недельный курс совместно с РБВ** следует рассмотреть при ВН ВГС >800 000 ME/мл и/или при наличии полиморфизмов NS5A; б - для ГТ 3 можно рассмотреть добавление РБВ**; в - в случае недоступности иных схем лечения. Все схемы ПВТ для лечения пациентов с ХВГС (всех ГТ ВГС) с ЦП (в т.ч. декомпенсированным) или без него, с опытом предшествующей ПВТ или без него, суммированы также в Приложении А3.
3.3 Контроль терапии  Всем пациентам, получившим ПВТ ХВГС, рекомендуется провести качественное определение РНК ВГС через 12 недель после окончания лечения, с тем чтобы оценить эффективность проведенной ПВТ. Рекомендуется использовать методы с высокой чувствительностью (≤15 МЕ/мл). Отсутствие РНК ВГС через 12 недель после окончания ПВТ означает излечение от ХВГС. Напротив, положительный результат РНК ВГС в эти сроки указывает на неудачу проведенного лечения. Уровень убедительности рекомендаций С (уровень достоверности доказательств – 4)  При применении РБВ** рекомендуется раз в 2-4 недели исследовать общий развернутый (клинический) анализ крови, и при снижении гемоглобина на 10 г/л от исходного и более уменьшить дозу препарата на 200 мг/сут, а при концентрации гемоглобина менее 85 г/л отменить терапию РБВ**. Уровень убедительности рекомендаций С (уровень достоверности доказательств – 5) Комментарии: Большинство современных препаратов ПВТ ХВГС хорошо переносятся, однако в ряде случаев необходимо добавлять РБВ** (для некоторых схем, особенно для пациентов с ЦП) – препарат, одним из основных побочных эффектов которого является не иммунный гемолиз. При применении РБВ** следует контролировать общий развернутый (клинический) анализ крови и при необходимости проводить коррекцию терапии.  По решению лечащего врача, независимо от условий оказания медицинской помощи, для контроля ПВТ (в т.ч. оценки эффективности и безопасности) взрослых пациентов с ХВГС рекомендуется рассмотреть применение телемедицинских технологий. Уровень убедительности рекомендаций С (уровень достоверности доказательств – 3)
3.4 Перелечивание В большинстве случаев (95-100%) применение ПППД приводит к УВО, однако в редких случаях достичь УВО не удается.  При неэффективности терапии ПППД рекомендуется использовать схему с другими препаратами, а также комбинацию из трех препаратов различного механизма действия (препаратом, ингибирующим NS3/NS4A + препаратом, ингибирующим NS5A + препаратом, ингибирующим NS5B) без РБВ** или с добавлением его. Если доступно исследование мутаций резистентности ВГС к различным ПППД, рекомендуется выполнить его для рационального подбора новой схемы. Уровень убедительности рекомендаций С (уровень достоверности доказательств – 4). Комментарии: o Пациентам с ХВГС (ГТ 1-6) без ЦП или с компенсированным ЦП после неэффективной ПВТ препаратами, ингибирующими NS3/4А+/-NS5В: для перелечивания рекомендуется пангенотипная схема велпатасвир + софосбувир** 100/400 мг в течение 12 недель; o Пациентам с ХВГС (ГТ 1-6) с декомпенсированным ЦП после неэффективной ПВТ препаратами, ингибирующими NS3/4А+/-NS5В: для перелечивания рекомендуется пангенотипная схема велпатасвир + софосбувир** 100/400 мг в комбинации с РБВ** (600 – 1200 мг/сут) в течение 12 недель; o Пациентам с ХВГС (ГТ 1-6) без ЦП или с ЦП (компенсированным и декомпенсированным) после неэффективной ПВТ препаратами, ингибирующими NS5А: для перелечивания рекомендуется пангенотипная схема велпатасвир + софосбувир** 100/400 мг в комбинации с РБВ** (600 – 1200 мг/сут) в течение 24 недель; o Пациентам с ХВГС (ГТ 1) без ЦП или с компенсированным ЦП после неэффективной ПВТ препаратами, ингибирующими NS3/4А без препаратамов, ингибирующих NS5A: для перелечивания рекомендуется схема глекапревир + пибрентасвир** (300/120 мг) в течение 12 недель; o Пациентам с ХВГС (ГТ 1) без ЦП или с компенсированным ЦП после неэффективной ПВТ препаратами, ингибирующими NS5A, без препаратов, ингибирующих NS3/4А: для перелечивания рекомендуется схема глекапревир + пибрентасвир** (300/120 мг) в течение 16 недель; o Пациентам с ХВГС (ГТ 1-6) без ЦП или с компенсированным ЦП после неэффективной ПВТ препаратами, ингибирующими NS3/4А и NS5А: по решению врачебной комиссии для перелечивания можно рассмотреть #глекапревир + пибрентасвир** (300/120 мг 1р/д) в сочетании с софосбувиром** (400 мг 1 р/д) внутрь и/или РБВ** (1000-1200 мг/сут) в течение 12-24 недель. Длительность курса определяется индивидуально и зависит, в том числе, от стадии фиброза печени и наличия резистентных к ПППД вариантов ВГС.
3.7 Хирургическое лечение  Рекомендуется проведение трансплантации печени при наличии стойких признаков декомпенсации функции печени пациентам с ЦП для сохранения жизни. Уровень достоверности рекомендации С (уровень убедительности доказательств – 4) Комментарий: дообследование проводится в соответствии с протоколом ведения пациентов из листа ожидания в трансплантологическом центре.  Пациентам с ЦП рекомендуется выполнение эндоскопического лигирования или склерозирования ВРВ пищевода и желудка для профилактики кровотечения или его купирования. Уровень убедительности рекомендаций С (уровень достоверности доказательств – 4)  Рекомендуется выполнение лапароцентеза пациентам с ЦП при наличии рефрактерного асцита для его купирования. Уровень убедительности рекомендаций С (уровень достоверности доказательств – 5)  Рекомендуется выполнение трансъюгулярного внутрипеченочного порто-системного шунтирования пациентам при наличии выраженной портальной гипертензии. Уровень убедительности рекомендаций С (уровень достоверности доказательств – 5)
3.8 Внепеченочные проявления хронического вирусного гепатита С  Пациентам с внепеченочными иммунологически обусловленными проявлениями ХВГС рекомендуется назначить ПППД по описанным выше схемам. Уровень убедительности рекомендаций С (уровень достоверности доказательств – 5) Комментарии: ХВГС может проявиться внепеченочными иммунологически обусловленными состояниями (криоглобулинемический васкулит, в том числе с синдромом Рейно, интерстициальные заболевания легких, гломерулонефрит, синдром Шегрена, артрит и другие), а также неходжкинскими В-клеточными лимфомами. Во всех случаях следует назначить ПППД по описанным выше схемам. Раннее начало ПВТ значительно снижает риск развития внепеченочных проявлений.
3.9 «Трансплантация печени» и в Приложении А3. Принципы перелечивания после неуспешного курса ПППД (ингибиторующими NS3/4А и/или ингибиторующими NS5A) рассматриваются в разделе 3.4.  Лечение пациентов с ХВГС без ЦП, без опыта ПВТ и без трансплантации печени в анамнезе рекомендуется проводить по одной из альтернативных схем согласно табл. 2: -Велпатасвир+Софосбувир** Уровень убедительности рекомендаций A (уровень достоверности доказательств – 2) -Глекапревир + Пибрентасвир** Уровень убедительности рекомендаций A (уровень достоверности доказательств – 2) -Даклатасвир** + Софосбувир** Уровень убедительности рекомендаций А (уровень достоверности доказательств – 3) -Гразопревир + Элбасвир** Уровень убедительности рекомендаций A (уровень достоверности доказательств – 2) -Даклатасвир** + Нарлапревир** + Ритонавир** Уровень убедительности рекомендаций С (уровень достоверности доказательств – 4) -Дасабувир; Омбитасвир + Паритапревир + Ритонавир** при генотипе 1b, -Дасабувир; Омбитасвир + Паритапревир + Ритонавир** + Рибавирин** при генотипе 1а Уровень убедительности рекомендаций A (уровень достоверности доказательств – 2) -Ледипасвир + Софосбувир Уровень убедительности рекомендаций A (уровень достоверности доказательств – 3) -Нарлапревир** + Софосбувир** + Ритонавир** Уровень убедительности рекомендаций В (уровень достоверности доказательств – 3) Табл. 2. Схемы ПВТ ХВГС для пациентов без предшествующего опыта ПВТ и без цирроза печени в зависимости от генотипа (лекарственные средства представлены в алфавитном порядке). Пангенотипные схемы лечения Генотип-специфичные схемы лечения ГЛЕ + ДАК**+ ДСВ; ВЕЛ + ДАК** + ГРА + ЛЕД + НРВ**/р** ГТ ПИБ* НРВ**/р* ОБВ+П СОФ** СОФ** ЭЛБ** СОФ + СОФ** * * ТВ/р** 12/16 12 нед. + 1а - нед.а РБВ** 12 нед. 8 нед. 8/12 #8 нед. в 1b 8/12 нед.б 12 нед. нед.б 2 12 нед. 8 нед. 12 нед. - - - - - 12 нед + 3 - - - - СОФ** 12/16 4 - - 12 нед. - нед.а Примечания: ВЕЛ+СОФ** – велпатасвир + софосбувир** (100/400 мг) 1 таб. 1р/д; ГЛЕ+ПИБ** – глекапревир + пибрентасвир** (3 таб. одновременно, по 100/40 мг каждая) 1р/д; ДАК** + СОФ** – даклатасвир** 60 мг 1 таб. 1р/д + софосбувир** 400 мг 1 таб. 1р/д; ГРА+ЭЛБ** – гразопревир + элбасвир** 100/50 мг 1 таб. 1р/д; ДАК** + НРВ**/р** – даклатасвир** 60 мг 1р/д + нарлапревир** 200 мг 1 р/д (2 таб. одновременно, по 100 мг каждая) + ритонавир** 100 мг 1р/д; ДСВ; ОБВ+ПТВ/р** – дасабувир (1 таб. по 250 мг 2 р/д); омбитасвир + паритапревир + ритонавир** (2 таб. одновременно 1р/д, по 12,5/75/50 мг каждая); ЛЕД+СОФ – ледипасвир + софосбувир 90/400 мг 1 таб. 1р/д; НРВ**/р** + СОФ** – нарлапревир** 200 мг 1 р/д (2 таб. одновременно, по 100 мг каждая) + ритонавир** 100 мг 1р/д + софосбувир** 400 мг 1 таб. 1р/д; а - при ВН не более 800 000 МЕ/мл срок лечения 12 недель; 16-недельный курс совместно с РБВ** следует рассмотреть при ВН ВГС >800 000 ME/мл и/или при наличии полиморфизмов NS5A; б - у пациентов со слабовыраженным фиброзом (F0-2) 8 недель, с фиброзом F3-F4 по METAVIR – 12 недель. в - у пациентов со слабовыраженным фиброзом (F0-2) и ВН менее 1 000 000 МЕ/мл можно рассмотреть длительность 8 недель по решению врачебной комиссии.  Лечение пациентов с ХВГС с компенсированным ЦП без опыта ПВТ рекомендуется проводить по одной из альтернативных схем согласно табл. 3: -Велпатасвир + Софосбувир** Уровень убедительности рекомендаций A (уровень достоверности доказательств – 3) -Глекапревир + Пибрентасвир** Уровень убедительности рекомендаций A (уровень достоверности доказательств – 4) -Даклатасвир** + Софосбувир** при генотипе 1, 2 и 4 Уровень убедительности рекомендаций A (уровень достоверности доказательств – 3) -Даклатасвир** + Софосбувир** + Рибавирин** при генотипе 3 Уровень убедительности рекомендаций A (уровень достоверности доказательств – 3) -Гразопревир + Элбасвир** Уровень убедительности рекомендаций A (уровень достоверности доказательств – 2) -Дасабувир; Омбитасвир + Паритапревир + Ритонавир** при генотипе 1b, -Дасабувир; Омбитасвир + Паритапревир + Ритонавир** + Рибавирин** при генотипе 1а Уровень убедительности рекомендаций A (уровень достоверности доказательств – 2) -Ледипасвир + Софосбувир или Ледипасвир + Софосбувир + Рибавирин** Уровень убедительности рекомендаций A (уровень достоверности доказательств – 3) Табл. 3.Примечания: ВЕЛ+СОФ** – велпатасвир + софосбувир** (100/400 мг) 1 таб. 1р/д; ГЛЕ+ПИБ** – глекапревир + пибрентасвир** (3 таб. одновременно, по 100/40 мг каждая) 1р/д; ДАК**+СОФ** – даклатасвир** 60 мг 1 таб. 1р/д + софосбувир** 400 мг 1 таб. 1р/д; ГРА+ЭЛБ** – гразопревир + элбасвир** 100/50 мг 1 таб. 1р/д; ДСВ; ОБВ+ПТВ/р** – дасабувир (1 таб. по 250 мг 2 р/д); омбитасвир + паритапревир + ритонавир** (2 таб. одновременно 1р/д, по 12,5/75/50 мг каждая); ЛЕД+СОФ – ледипасвир + софосбувир 90/400 мг 1 таб. 1р/д; а - при ВН не более 800 000 МЕ/мл срок лечения 12 недель; 16-недельный курс совместно с РБВ** следует рассмотреть при ВН ВГС >800 000 ME/мл и/или при наличии полиморфизмов NS5A; б - для ГТ 3 можно рассмотреть добавление РБВ**; в - в случае недоступности иных схем лечения.  Лечение пациентов с ХВГС, не ответивших на предшествующую терапию ПегИФН** + РБВ** ± СОФ** или СОФ** + РБВ**, без ЦП рекомендуется проводить по одной из альтернативных схем согласно табл. 4: -Велпатасвир + Софосбувир** Уровень убедительности рекомендаций A (уровень достоверности доказательств – 3) -Глекапревир + Пибрентасвир** Уровень убедительности рекомендаций A (уровень достоверности доказательств – 3) - Даклатасвир** + Софосбувир** Уровень убедительности рекомендаций A (уровень достоверности доказательств – 3) -Гразопревир + Элбасвир** Уровень убедительности рекомендаций A (уровень достоверности доказательств – 2) -Дасабувир; Омбитасвир + Паритапревир + Ритонавир** при генотипе 1b, -Дасабувир; Омбитасвир + Паритапревир + Ритонавир** + Рибавирин** при генотипе 1а Уровень убедительности рекомендаций A (уровень достоверности доказательств – 2) -Ледипасвир + Софосбувир или Ледипасвир+Софосбувир + Рибавирин** Уровень убедительности рекомендаций A (уровень достоверности доказательств – 3) Табл. 4. Схемы ПВТ ХВГС для пациентов, не ответивших на предшествующую терапию ПегИФН** + РБВ** ± СОФ** или СОФ** + РБВ**, без цирроза печени в зависимости от генотипа (лекарственные средства представлены в алфавитном порядке). Пангенотипные схемы лечения Генотип-специфичные схемы лечения ВЕЛ + ГЛЕ + ГРА + ДСВ; ГТ ДАК** + СОФ** ЛЕД + СОФ СОФ** ПИБ** ЭЛБ** ОБВ+ПТВ/р** 12/16 1а 12 нед.+ РБВ** 12 нед. 8 нед. 12 нед. нед.а 12 недель 1b 12 нед. 12 нед. 2 - - - 3 16 нед. - - 24 нед + РБВ** 12/16 4 8 нед. - 12 недель нед.а Примечания: ВЕЛ+СОФ** – велпатасвир + софосбувир** (100/400 мг) 1 таб. 1р/д; ГЛЕ+ПИБ** – глекапревир + пибрентасвир** (3 таб. одновременно, по 100/40 мг каждая) 1р/д; ДАК** + СОФ** – даклатасвир** 60 мг 1 таб. 1р/д + софосбувир** 400 мг 1 таб. 1р/д; ГРА+ЭЛБ** – гразопревир + элбасвир** 100/50 мг 1 таб. 1р/д; ДСВ; ОБВ+ПТВ/р** – дасабувир (1 таб. по 250 мг 2 р/д); омбитасвир + паритапревир + ритонавир** (2 таб. одновременно 1р/д, по 12,5/75/50 мг каждая); ЛЕД+СОФ – ледипасвир + софосбувир 90/400 мг 1 таб. 1р/д; а – при ВН не более 800 000 МЕ/мл срок лечения 12 недель; 16-недельный курс совместно с РБВ** следует рассмотреть при ВН ВГС >800 000 ME/мл и/или при наличии полиморфизмов NS5A.  Лечение пациентов с ХВГС, не ответивших на предшествующую терапию ПегИФН** + РБВ** ± СОФ** или СОФ** + РБВ**, с компенсированным ЦП рекомендуется проводить по одной из альтернативных схем согласно табл. 5: -Велпатасвир + Софосбувир** Уровень убедительности рекомендаций A (уровень достоверности доказательств – 2) -Глекапревир + Пибрентасвир** Уровень убедительности рекомендаций A (уровень достоверности доказательств – 3) -Даклатасвир** + Софосбувир** Уровень убедительности рекомендаций A (уровень достоверности доказательств – 3) -Даклатасвир** + Софосбувир** + Рибавирин** Уровень убедительности рекомендаций A (уровень достоверности доказательств – 2) -Гразопревир + Элбасвир** Уровень убедительности рекомендаций A (уровень достоверности доказательств – 2) -Дасабувир; Омбитасвир + Паритапревир + Ритонавир** при генотипе 1b, -Дасабувир; Омбитасвир + Паритапревир + Ритонавир** + Рибавирин** при генотипе 1а Уровень убедительности рекомендаций A (уровень достоверности доказательств – 2) -Ледипасвир + Софосбувир или Ледипасвир+Софосбувир + Рибавирин** Уровень убедительности рекомендаций A (уровень достоверности доказательств – 3) Табл. 5.Примечания: ВЕЛ+СОФ** – велпатасвир + софосбувир** (100/400 мг) 1 таб. 1р/д; ГЛЕ+ПИБ** – глекапревир + пибрентасвир** (3 таб. одновременно, по 100/40 мг каждая) 1р/д; ДАК** + СОФ** – даклатасвир** 60 мг 1 таб. 1р/д + софосбувир** 400 мг 1 таб. 1р/д; ГРА+ЭЛБ** – гразопревир + элбасвир** 100/50 мг 1 таб. 1р/д; ДСВ; ОБВ+ПТВ/р** – дасабувир (1 таб. по 250 мг 2 р/д); омбитасвир + паритапревир + ритонавир** (2 таб. одновременно 1р/д, по 12,5/75/50 мг каждая); ЛЕД+СОФ – ледипасвир + софосбувир 90/400 мг 1 таб. 1р/д; а - при ВН не более 800 000 МЕ/мл срок лечения 12 недель; 16-недельный курс совместно с РБВ** следует рассмотреть при ВН ВГС >800 000 ME/мл и/или при наличии полиморфизмов NS5A; б - для ГТ 3 можно рассмотреть добавление РБВ**; в - в случае недоступности иных схем лечения. Все схемы ПВТ для лечения пациентов с ХВГС (всех ГТ ВГС) с ЦП (в т.ч. декомпенсированным) или без него, с опытом предшествующей ПВТ или без него, суммированы также в Приложении А3. 3.3 Контроль терапии  Всем пациентам, получившим ПВТ ХВГС, рекомендуется провести качественное определение РНК ВГС через 12 недель после окончания лечения, с тем чтобы оценить эффективность проведенной ПВТ. Рекомендуется использовать методы с высокой чувствительностью (≤15 МЕ/мл). Отсутствие РНК ВГС через 12 недель после окончания ПВТ означает излечение от ХВГС. Напротив, положительный результат РНК ВГС в эти сроки указывает на неудачу проведенного лечения. Уровень убедительности рекомендаций С (уровень достоверности доказательств – 4)  При применении РБВ** рекомендуется раз в 2-4 недели исследовать общий развернутый (клинический) анализ крови, и при снижении гемоглобина на 10 г/л от исходного и более уменьшить дозу препарата на 200 мг/сут, а при концентрации гемоглобина менее 85 г/л отменить терапию РБВ**. Уровень убедительности рекомендаций С (уровень достоверности доказательств – 5) Комментарии: Большинство современных препаратов ПВТ ХВГС хорошо переносятся, однако в ряде случаев необходимо добавлять РБВ** (для некоторых схем, особенно для пациентов с ЦП) – препарат, одним из основных побочных эффектов которого является не иммунный гемолиз. При применении РБВ** следует контролировать общий развернутый (клинический) анализ крови и при необходимости проводить коррекцию терапии.  По решению лечащего врача, независимо от условий оказания медицинской помощи, для контроля ПВТ (в т.ч. оценки эффективности и безопасности) взрослых пациентов с ХВГС рекомендуется рассмотреть применение телемедицинских технологий. Уровень убедительности рекомендаций С (уровень достоверности доказательств – 3) 3.4 Перелечивание В большинстве случаев (95-100%) применение ПППД приводит к УВО, однако в редких случаях достичь УВО не удается.  При неэффективности терапии ПППД рекомендуется использовать схему с другими препаратами, а также комбинацию из трех препаратов различного механизма действия (препаратом, ингибирующим NS3/NS4A + препаратом, ингибирующим NS5A + препаратом, ингибирующим NS5B) без РБВ** или с добавлением его. Если доступно исследование мутаций резистентности ВГС к различным ПППД, рекомендуется выполнить его для рационального подбора новой схемы. Уровень убедительности рекомендаций С (уровень достоверности доказательств – 4). Комментарии: o Пациентам с ХВГС (ГТ 1-6) без ЦП или с компенсированным ЦП после неэффективной ПВТ препаратами, ингибирующими NS3/4А+/-NS5В: для перелечивания рекомендуется пангенотипная схема велпатасвир + софосбувир** 100/400 мг в течение 12 недель; o Пациентам с ХВГС (ГТ 1-6) с декомпенсированным ЦП после неэффективной ПВТ препаратами, ингибирующими NS3/4А+/-NS5В: для перелечивания рекомендуется пангенотипная схема велпатасвир + софосбувир** 100/400 мг в комбинации с РБВ** (600 – 1200 мг/сут) в течение 12 недель; o Пациентам с ХВГС (ГТ 1-6) без ЦП или с ЦП (компенсированным и декомпенсированным) после неэффективной ПВТ препаратами, ингибирующими NS5А: для перелечивания рекомендуется пангенотипная схема велпатасвир + софосбувир** 100/400 мг в комбинации с РБВ** (600 – 1200 мг/сут) в течение 24 недель; o Пациентам с ХВГС (ГТ 1) без ЦП или с компенсированным ЦП после неэффективной ПВТ препаратами, ингибирующими NS3/4А без препаратамов, ингибирующих NS5A: для перелечивания рекомендуется схема глекапревир + пибрентасвир** (300/120 мг) в течение 12 недель; o Пациентам с ХВГС (ГТ 1) без ЦП или с компенсированным ЦП после неэффективной ПВТ препаратами, ингибирующими NS5A, без препаратов, ингибирующих NS3/4А: для перелечивания рекомендуется схема глекапревир + пибрентасвир** (300/120 мг) в течение 16 недель; o Пациентам с ХВГС (ГТ 1-6) без ЦП или с компенсированным ЦП после неэффективной ПВТ препаратами, ингибирующими NS3/4А и NS5А: по решению врачебной комиссии для перелечивания можно рассмотреть #глекапревир + пибрентасвир** (300/120 мг 1р/д) в сочетании с софосбувиром** (400 мг 1 р/д) внутрь и/или РБВ** (1000-1200 мг/сут) в течение 12-24 недель. Длительность курса определяется индивидуально и зависит, в том числе, от стадии фиброза печени и наличия резистентных к ПППД вариантов ВГС. 3.5 Патогенетическая терапия Патогенетической терапии для пациентов с ХВГС нет. 3.6 Симптоматическая терапия Симптоматической терапии для пациентов с ХВГС нет. 3.7 Хирургическое лечение  Рекомендуется проведение трансплантации печени при наличии стойких признаков декомпенсации функции печени пациентам с ЦП для сохранения жизни. Уровень достоверности рекомендации С (уровень убедительности доказательств – 4) Комментарий: дообследование проводится в соответствии с протоколом ведения пациентов из листа ожидания в трансплантологическом центре.  Пациентам с ЦП рекомендуется выполнение эндоскопического лигирования или склерозирования ВРВ пищевода и желудка для профилактики кровотечения или его купирования. Уровень убедительности рекомендаций С (уровень достоверности доказательств – 4)  Рекомендуется выполнение лапароцентеза пациентам с ЦП при наличии рефрактерного асцита для его купирования. Уровень убедительности рекомендаций С (уровень достоверности доказательств – 5)  Рекомендуется выполнение трансъюгулярного внутрипеченочного порто-системного шунтирования пациентам при наличии выраженной портальной гипертензии. Уровень убедительности рекомендаций С (уровень достоверности доказательств – 5) 3.8 Внепеченочные проявления хронического вирусного гепатита С  Пациентам с внепеченочными иммунологически обусловленными проявлениями ХВГС рекомендуется назначить ПППД по описанным выше схемам. Уровень убедительности рекомендаций С (уровень достоверности доказательств – 5) Комментарии: ХВГС может проявиться внепеченочными иммунологически обусловленными состояниями (криоглобулинемический васкулит, в том числе с синдромом Рейно, интерстициальные заболевания легких, гломерулонефрит, синдром Шегрена, артрит и другие), а также неходжкинскими В-клеточными лимфомами. Во всех случаях следует назначить ПППД по описанным выше схемам. Раннее начало ПВТ значительно снижает риск развития внепеченочных проявлений. 3.9 Коинфекция 3.9.1 Коинфекция ВГС/ВИЧ Пациенты с ХВГС и коинфекцией ВИЧ относятся к группе, требующей безотлагательной ПВТ ХВГС. Течение ХВГС у ВИЧ-инфицированных зависит от степени выраженности иммунодефицита, обусловленного ВИЧ. Вероятность развития тяжелого поражения печени особенно высока при снижении CD4 лимфоцитов менее 200/мкл. Прогрессирование, связанное с поражением печени, обусловлено повышением концентрации вируса в крови (в 2-8 раз) на фоне выраженного иммунодефицита. Коинфекция ВИЧ и ВГС приводит к увеличению частоты развития осложнений, а также связанной с этими заболеваниями смертности. Антиретровирусная терапия коинфицированных ВГС/ВИЧ больных ассоциирована с возможным риском нарушения функций печени вследствие ее гепатотоксичности.  Для лечения ХВГС у больных, коинфицированных ВИЧ, рекомендуется использовать те же схемы ПВТ, что и для лечения моноинфекции ВГС, с целью эрадикации ВГС. Уровень убедительности рекомендаций С (уровень достоверности доказательств – 4). Комментарии: все схемы ПВТ на основе ПППД требуют учета межлекарственных взаимодействий. Одним из удобных способов оценки межлекарственных взаимодействий является использование Ливерпульской таблицы лекарственных взаимодействий в Интернет ресурсе (http://www.hep-druginteractions.org). 3.9.2 Коинфекция ВГС/ВГВ Пациенты с ХВГС и коинфекцией вирусом гепатита В (ВГВ) относятся к группе, требующей безотлагательной ПВТ ХВГС. Коинфекция ВГС/ВГВ ускоряет прогрессирование заболевания и увеличивает риск развития ГЦК.  Всем больным ХВГС рекомендуется провести тестирование на наличие перенесенной или текущей инфекции, вызванной ВГВ (HBsAg, anti-HBs, anti-HBc суммарные). Уровень убедительности рекомендаций C (уровень достоверности доказательств – 4)  Пациентам с коинфекцией ВГС/ВГВ рекомендуется назначить ПВТ нуклеозидами и нуклеотидами, кроме ингибиторов обратной транскриптазы, для профилактики реактивации инфекции, вызванной ВГВ. ПВТ нуклеозидами и нуклеотидами, кроме ингибиторов обратной транскриптазы, рекомендуется назначить на весь срок терапии ХВГС, а также на 12 недель после ее успешного завершения. Уровень убедительности рекомендаций А (уровень достоверности доказательств – 2) Комментарии: поскольку ВГС, как правило, подавляет репликацию ВГВ, устранение первого вируса может привести к реактивации второго. Поэтому при лечении ХВГС следует тщательно контролировать маркеры активности ВГВ, и при их увеличении назначить ПВТ инфекции, вызванной ВГВ. Эту терапию также можно назначить с профилактической целью на срок лечение ХВГС и далее в течение 12 недель после ее успешного завершения.  Пациентам с ХВГС и anti-HBc (в отсутствии HBsAg и anti-HBs) во время ПВТ ХВГС рекомендуется ежемесячный контроль АЛТ для исключения реактивации ВГВ. Уровень убедительности рекомендаций А (уровень достоверности доказательств – 2)  При коинфекции ВГС/ВГВ для лечения ХВГС рекомендуется использовать стандартные схемы, описанные выше. Уровень убедительности рекомендаций А (уровень достоверности доказательств – 2)
3.10 Пациенты с хронической болезнью почек  Для ПВТ ХВГС у пациентов с ХБП (включая тяжелую, с СКФ <30 мл/мин/1,73 м2) рекомендуется использование ПППД в соответствии с общими рекомендациями ПВТ ХВГС пациентов без ХБП (см. подраздел 3.2 и Приложение А3). Уровень убедительности рекомендаций А (уровень достоверности доказательств – 1) Комментарии: на сегодня накоплено достаточно клинического опыта применения софосбувира** у пациентов с тяжелой ХБП, что позволяет рекомендовать софосбувир**-содержащие схемы ПВТ всем таким пациентам без коррекции доз ПППД.  Для ПВТ ХВГС у пациентов с тяжелой ХБП (с СКФ <30 мл/мин/1,73 м2), тем не менее, рекомендуется по возможности отдавать предпочтение схемам, не содержащим софосбувир**: o Глекапревир + пибрентасвир** для всех ГТ ВГС; o Дасабувир; омбитасвир + паритапревир + ритонавир** для ГТ 1; o Элбасвир + гразопревир** для ГТ 1, 4; Уровень убедительности рекомендаций A (уровень достоверности доказательств – 2)  Пациентам с декомпенсированным ЦП (класс В или С по Child-Pugh) и тяжелой ХБП (с СКФ <30 мл/мин/1,73 м2) рекомендуется назначать следующие схемы ПВТ ХВГС в течение 24 недель: o Велпатасвир + софосбувир** (для всех ГТ); Уровень убедительности рекомендаций С (уровень достоверности доказательств – 4) o Даклатасвир** 1 таб. (60 мг) 1 р/д + #софосбувир** 1 таб. (400 мг) 1 р/д (для всех ГТ); o Ледипасвир + cофосбувир (для ГТ 1 и 4). Уровень убедительности рекомендаций A (уровень достоверности доказательств – 2)
3.11 Трансплантация печени 3.11.1 Противовирусная терапия ХВГС у больных с декомпенсированным циррозом печени, находящихся в Листе ожидания трансплантации печени Целями ПВТ ХВГС у больных с декомпенсированным ЦП, находящихся в Листе ожидания ортотопической трансплантации печени (ОТП), являются: o Предотвращение инфицирования трансплантата печени; o Улучшение функции печени перед трансплантацией; o Выведение пациента из Листа ожидания ОТП. Улучшение функции печени оценивается по клиническим показателям, а также по шкалам Child-Pugh (см. Приложение Г) и MELD (для подсчета этого индекса можно использовать любой интернет-ресурс, например, https://www.mdcalc.com/meldna-meld-na-score- liver-cirrhosis). Улучшение оценки MELD наблюдается у 60% больных с декомпенсированным ЦП, завершивших курс ПВТ. Это улучшение тем более вероятно и тем сильнее выражено, чем ниже оценка MELD до начала терапии. До 25-30% больных с декомпенсированным ЦП могут иметь стойкое улучшение (компенсацию) ЦП, что позволяет вывести их из Листа ожидания ОТП. Выживаемость таких пациентов на протяжении 3-х лет не ниже, чем в группе реципиентов печени, которым была проведена ОТП, сопоставимых по исходной MELD.  Больным с декомпенсированным циррозом в исходе ХВГС (Child-Pugh В или С) без ГЦК, ожидающим ОТП, рекомендуется назначать ПВТ, если MELD <20. ПВТ рекомендуется начинать как можно быстрее, чтобы завершить курс и оценить ответ до трансплантации. Уровень убедительности рекомендаций В (уровень достоверности доказательств – 1) Комментарии: для ПВТ пациентов с декомпенсированным ЦП строго противопоказано использование препаратов, ингибирующих NS3/4.  Больным с декомпенсированным ЦП в исходе ХВГС (Child-Pugh В или С) без ГЦК, ожидающим трансплантацию печени, с MELD ≥20 рекомендуется провести ОТП, не назначая ПВТ. ПВТ ХВГС рекомендуется провести после трансплантации. Уровень убедительности рекомендаций В (уровень достоверности доказательств – 1)  Больным с декомпенсированным ЦП в исходе ХВГС (Child-Pugh В или С) без ГЦК, ожидающие ОТП, с MELD ≥20 могут начать лечение до ОТП, если предполагаемое время ожидания органа превышает 6 месяцев. Уровень убедительности рекомендаций В (уровень достоверности доказательств – 1) 3.11.2 Противовирусная терапия инфекции, вызванной вирусом гепатита С, у реципиентов печени  ПВТ инфекции трансплантата, вызванной ВГС, рекомендуется проводить всем реципиентам, у которых выявляется РНК ВГС в крови, насколько это возможно по состоянию пациента. Уровень убедительности рекомендаций А (уровень достоверности доказательств – 1) Комментарии: частота УВО у реципиентов печени с компенсированной болезнью трансплантата, получивших запланированный курс ПВТ, составляет более 95%. УВО ассоциируется с замедлением прогрессирования фиброза и улучшением выживаемости трансплантата и реципиентов.
3.12 Беременные Беременность, по-видимому, не оказывает негативного влияния на течение ХВГС. Активность АЛТ в сыворотке крови снижается в течение I и III триместров беременности и повышаются после родов. Уровень РНК ВГС повышается в течение I и III триместров, достигая пика в течение III триместра, и снижается после родоразрешения. Эти события, вероятно, обусловлены иммуносупрессивными эффектами беременности и увеличением объема материнской плазмы. Передача ВГС от матери ребенку встречается с общей частотой от 5% до 15%. Убедительных данных о негативном влиянии ВГС на развитие плода и исход беременности нет. Есть отдельные сообщения о влиянии ЦП на течение беременности и ее исход. Так, беременные женщины с ЦП подвергаются повышенному риску неблагоприятных исходов для матери (например, преэклампсия, геморрагические осложнения и смерть) и для плода (например, преждевременные роды, низкая масса тела при рождении и неонатальная смерть). Женщины с ЦП в исходе ХВГС должны быть проинформированы об этих возможных осложнениях.  Женщинам репродуктивного возраста рекомендуется ПВТ ХВГС до планирования беременности, с тем чтобы снизить риск передачи ВГС будущему ребенку. Уровень убедительности рекомендаций C (уровень достоверности доказательств – 5)  Для выявления ХВГС рекомендуется проводить обследование беременных на anti-HCV крови (Определение суммарных антител классов M и G (anti-HCV IgG и anti-HCV IgM) к вирусу гепатита C (Hepatitis C virus) в крови) в I (при постановке на учет по беременности) и в III триместрах беременности. Уровень убедительности рекомендаций С (уровень достоверности доказательств – 5)  Не рекомендуется проводить ПВТ ПППД во время беременности из-за отсутствия в настоящее время достаточных данных о безопасности и эффективности ПППД. Уровень убедительности рекомендаций С (уровень достоверности доказательств – 4) Комментарии: на сегодня не существует крупномасштабных клинических испытаний, оценивающих безопасность ПППД при беременности. Специальные исследования ПВТ СОФ** и ЛЕД+СОФ во время беременности продемонстрировали хорошую безопасность для плода. Данных об использовании пангенотипных схем во время беременности в настоящее время нет.  Женщинам детородного возраста, получающим ПВТ ХВГС с РБВ**, не рекомендуется беременность во время приема ПВТ и в течение не менее 6 месяцев после прекращения ПВТ. Уровень убедительности рекомендаций С (уровень достоверности доказательств – 4)  Мужчинам, получающим ПВТ ХВГС с РБВ**, не рекомендуется беременность их половых партнерш во время приема ПВТ и в течение не менее 6 месяцев после прекращения ПВТ. Уровень убедительности рекомендаций С (уровень достоверности доказательств – 4) Комментарии: РБВ** обладает тератогенным свойством, то есть может вызвать аномалии развития и гибель плода. Его не следует назначать беременным женщинам или женщинам детородного возраста, которые могут забеременеть во время лечения РБВ** или в течение 6 месяцев после прекращения РБВ**. Кроме того, следует помнить, что РБВ** аналогичным образом может вызывать врожденные дефекты у плода, в случае если мужчина получал РБВ**, когда женщина забеременела от него. Таким образом, для избегания беременности во время лечения РБВ** и в течение не менее 6 месяцев после этого лицам с детородным потенциалом крайне важно использовать по крайней мере 2 формы эффективной контрацепции. Консультирующему врачу необходимо задокументировать обсуждение потенциальных тератогенных эффектов РБВ** в медицинской карте пациента.  Женщинам с ХВГС не рекомендуется отмена грудного вскармливания, за исключением случаев повреждения сосков и кровотечения из этих повреждений. Уровень убедительности рекомендаций C (уровень достоверности доказательств – 4) Комментарии: грудное вскармливание не представляет риска для передачи ВГС от матери ребенку, поскольку частота инфицирования детей по результатам исследований сопоставима в группах на грудном вскармливании и на искусственном вскармливании. Однако в случае повреждения сосков и кровотечения из этих повреждений возникает риск инфицирования ребенка от матери с ХВГС вследствие передачи ВГС через кровь.
